1697 -1
721 436 707 67 707 -1
436 1785 436 -1
436 1529 -1
1785 570 1457 1318 325 -1
707 1482 707 -1
707 1529 -1
67 1376 912 1863 1416 802 -1
1482 171 1457 1318 427 529 264 1991 746 1979 325 1392 802 -1
1392 1675 1991 1473 1979 325 -1
1392 1529 -1
746 1318 571 528 1294 -1
1294 1581 1318 571 528 1294 -1
1294 1529 -1
1473 1318 571 1628 1327 -1
1327 1581 1318 571 1628 1327 -1
1327 1529 -1
528 613 -1
528 926 -1
528 200 -1
528 1493 1991 1790 1979 1518 1628 -1
1628 613 -1
1628 926 -1
1628 200 -1
802 694 713 1555 -1
713 321 713 -1
713 1529 -1
321 1324 -1
321 1097 -1
321 1636 -1
321 32 -1
321 506 -1
1324 973 1098 1318 1086 325 -1
1324 1825 1098 1616 1086 325 -1
1324 1825 1098 1345 1086 325 -1
596 1991 1318 1979 -1
596 1529 -1
1097 345 -1
1097 1025 -1
345 1318 66 -1
66 619 479 -1
619 375 76 325 -1
479 1991 1634 1979 375 76 325 -1
1634 1601 -1
1634 1318 -1
1025 786 1154 1457 1318 1682 1821 196 325 -1
786 1991 196 1979 375 -1
786 1529 -1
196 1318 1044 -1
1044 1581 1318 1044 -1
1044 1529 -1
76 1016 -1
76 967 -1
967 366 1098 1934 1086 -1
967 1310 1098 1934 1086 -1
967 366 1616 -1
967 1310 1616 -1
1016 1238 1929 -1
1929 1323 1238 1929 -1
1929 1529 -1
1238 1934 735 -1
1238 1345 -1
735 1608 1934 735 -1
735 1529 -1
1934 1911 803 -1
803 923 1911 803 -1
803 1529 -1
1911 557 415 -1
415 968 557 415 -1
415 1529 -1
557 1098 1934 1086 -1
557 1616 -1
1616 1318 596 -1
1616 1601 -1
1616 1393 -1
1345 1653 -1
1345 867 -1
923 1310 -1
923 366 -1
968 511 -1
968 319 -1
1323 1197 -1
1323 1530 -1
1608 1433 -1
1608 1418 -1
1608 1268 -1
1608 1253 -1
1608 1199 -1
1608 1484 -1
1636 570 196 571 528 325 -1
32 1301 1098 1318 1086 694 13 1073 1555 -1
13 1830 131 571 713 1829 325 140 -1
140 1830 131 571 713 1829 325 140 -1
140 1529 -1
131 1601 -1
131 1345 -1
1073 216 571 713 1829 325 -1
1073 1529 -1
506 692 1098 1318 1328 1790 1086 694 713 1555 -1
506 1794 1098 1016 1086 694 713 1555 -1
1790 1601 1204 1601 -1
