0 91 -1
1 54 55 -1
2 54 55 53 -1
3 55 91 -1
4 55 91 -1
5 54 91 -1
6 64 -1
7 100 -1
8 100 -1
9 100 -1
10 100 -1
11 100 59 93 -1
12 100 59 -1
13 54 91 -1
14 107 103 -1
15 65 66 58 53 67 68 69 70 71 103 107 -1
16 65 66 58 53 67 68 69 70 71 103 107 -1
17 77 75 88 89 82 83 84 85 86 87 80 81 104 93 -1
18 77 75 88 89 82 83 84 85 86 87 80 81 104 93 -1
19 65 66 58 53 67 68 69 70 71 103 107 -1
20 65 66 58 53 67 68 69 70 71 103 107 -1
21 65 66 58 53 67 68 69 70 71 103 107 -1
22 65 66 58 53 67 68 69 70 71 103 107 -1
23 65 66 58 53 67 68 69 70 71 103 107 -1
24 100 -1
25 65 66 58 53 67 68 69 70 71 103 107 -1
26 69 -1
27 100 93 59 -1
28 100 93 59 -1
29 93 -1
30 93 -1
31 93 -1
32 93 -1
33 80 81 93 -1
34 80 81 93 -1
35 80 81 82 83 84 85 87 86 93 104 -1
36 80 81 82 83 84 85 87 86 93 104 -1
37 77 75 82 83 84 85 86 87 80 81 104 93 -1
38 77 75 82 83 84 85 86 87 80 81 104 93 -1
39 77 75 88 89 82 83 84 85 86 87 80 81 104 93 -1
-1 104 101 80 81 93 -1
41 76 58 73 72 -1
42 76 58 73 72 -1
43 76 58 73 72 78 79 -1
44 76 58 73 72 -1
45 65 66 58 53 67 68 69 70 71 103 107 -1
46 65 66 58 53 67 68 69 70 71 103 107 -1
47 108 103 -1
48 108 103 -1
49 101 -1
50 103 -1
51 65 66 58 53 67 68 69 70 71 103 107 -1
52 100 104 -1
