0 53 -1
1 63 59 -1
4 63 59 55 -1
2 59 53 -1
3 59 53 -1
5 63 53 -1
8 77 -1
7 68 -1
11 68 -1
9 68 -1
13 68 -1
10 68 71 58 -1
12 68 71 -1
6 63 53 -1
15 104 78 -1
16 79 82 57 55 110 106 85 67 108 78 104 -1
17 79 82 57 55 110 106 85 67 108 78 104 -1
22 89 88 93 94 97 98 99 100 101 102 95 96 81 58 -1
24 89 88 93 94 97 98 99 100 101 102 95 96 81 58 -1
18 79 82 57 55 110 106 85 67 108 78 104 -1
25 79 82 57 55 110 106 85 67 108 78 104 -1
27 79 82 57 55 110 106 85 67 108 78 104 -1
28 79 82 57 55 110 106 85 67 108 78 104 -1
29 79 82 57 55 110 106 85 67 108 78 104 -1
31 68 -1
26 79 82 57 55 110 106 85 67 108 78 104 -1
32 85 -1
33 68 58 71 -1
34 68 58 71 -1
30 58 -1
36 58 -1
35 58 -1
39 58 -1
38 95 96 58 -1
41 95 96 58 -1
37 95 96 97 98 99 100 102 101 58 81 -1
44 95 96 97 98 99 100 102 101 58 81 -1
43 89 88 97 98 99 100 101 102 95 96 81 58 -1
47 89 88 97 98 99 100 101 102 95 96 81 58 -1
46 89 88 93 94 97 98 99 100 101 102 95 96 81 58 -1
-1 81 70 95 96 58 -1
45 80 57 84 90 -1
48 80 57 84 90 -1
40 80 57 84 90 91 92 -1
42 80 57 84 90 -1
19 79 82 57 55 110 106 85 67 108 78 104 -1
20 79 82 57 55 110 106 85 67 108 78 104 -1
49 105 78 -1
52 105 78 -1
51 70 -1
50 78 -1
21 79 82 57 55 110 106 85 67 108 78 104 -1
14 68 81 -1