0 95 -1
1 58 59 95 -1
2 58 59 57 -1
3 59 95 -1
4 59 58 95 -1
5 58 95 -1
6 68 -1
7 104 -1
8 104 -1
9 104 -1
10 104 -1
11 104 63 97 -1
12 104 -1
13 104 63 -1
14 58 95 -1
15 111 107 -1
16 69 70 62 57 71 72 73 74 75 107 111 -1
17 69 70 62 57 71 72 73 74 75 107 111 -1
18 81 79 92 93 86 87 88 89 90 91 84 85 108 97 -1
19 81 79 92 93 86 87 88 89 90 91 84 85 108 97 -1
20 81 79 92 93 86 87 88 89 90 91 84 85 108 97 -1
21 69 70 62 57 71 72 73 74 75 107 111 -1
22 69 70 62 57 71 72 73 74 75 107 111 -1
23 69 70 62 57 71 72 73 74 75 107 111 -1
24 69 70 62 57 71 72 73 74 75 107 111 -1
25 69 70 62 57 71 72 73 74 75 107 111 -1
26 104 -1
27 69 70 62 57 71 72 73 74 75 107 111 -1
28 73 -1
29 104 97 63 -1
30 104 97 63 105 -1
31 97 -1
32 97 -1
33 80 62 77 76 -1
34 97 -1
35 108 97 -1
36 108 97 -1
37 84 85 97 -1
38 108 84 85 97 -1
39 84 85 86 87 88 89 91 90 97 108 -1
40 84 85 86 87 88 89 91 90 97 108 -1
41 81 79 86 87 88 89 90 91 84 85 108 97 -1
42 81 79 86 87 88 89 90 91 84 85 108 97 -1
43 81 79 92 93 86 87 88 89 90 91 84 85 108 97 -1
-1 108 105 84 85 97 -1
45 80 62 77 76 -1
46 80 62 77 76 -1
47 80 62 77 76 82 83 -1
48 80 62 77 76 -1
49 69 70 62 57 71 72 73 74 75 107 111 -1
50 69 70 62 57 71 72 73 74 75 107 111 -1
51 112 107 -1
52 112 107 -1
53 105 -1
54 107 -1
55 69 70 62 57 71 72 73 74 75 107 111 -1
56 104 108 -1
