0 53 -1
1 63 59 -1
2 63 59 55 -1
3 59 53 -1
4 59 53 -1
5 63 53 -1
6 77 -1
7 68 -1
8 68 -1
9 68 -1
10 68 -1
11 68 71 58 -1
12 68 71 -1
13 63 53 -1
14 104 78 -1
15 79 82 57 55 -1 106 85 67 108 78 104 -1
16 79 82 57 55 -1 106 85 67 108 78 104 -1
17 89 88 93 94 97 98 99 100 101 102 95 96 81 58 -1
18 89 88 93 94 97 98 99 100 101 102 95 96 81 58 -1
19 79 82 57 55 -1 106 85 67 108 78 104 -1
20 79 82 57 55 -1 106 85 67 108 78 104 -1
21 79 82 57 55 -1 106 85 67 108 78 104 -1
22 79 82 57 55 -1 106 85 67 108 78 104 -1
23 79 82 57 55 -1 106 85 67 108 78 104 -1
24 68 -1
25 79 82 57 55 -1 106 85 67 108 78 104 -1
26 85 -1
27 68 58 71 -1
28 68 58 71 -1
29 58 -1
30 58 -1
31 58 -1
32 58 -1
33 95 96 58 -1
34 95 96 58 -1
35 95 96 97 98 99 100 102 101 58 81 -1
36 95 96 97 98 99 100 102 101 58 81 -1
37 89 88 97 98 99 100 101 102 95 96 81 58 -1
38 89 88 97 98 99 100 101 102 95 96 81 58 -1
39 89 88 93 94 97 98 99 100 101 102 95 96 81 58 -1
-1 81 70 95 96 58 -1
41 80 57 84 90 -1
42 80 57 84 90 -1
43 80 57 84 90 91 92 -1
44 80 57 84 90 -1
45 79 82 57 55 -1 106 85 67 108 78 104 -1
46 79 82 57 55 -1 106 85 67 108 78 104 -1
47 105 78 -1
48 105 78 -1
49 70 -1
50 78 -1
51 79 82 57 55 -1 106 85 67 108 78 104 -1
52 68 81 -1
